{
    "maps":
    [
        {
            "id": 0,
            "name":"Map",
            "width": 9,
            "height": 9,
            "grid":
            [
                1,1,1,1,1,1,1,1,1,
                1,1,1,1,1,1,1,1,1,
                1,1,1,1,1,1,1,1,1,
                1,1,1,1,1,1,1,1,1,
                1,1,1,1,1,1,1,1,1,
                1,1,1,1,1,1,1,1,1,
                1,1,1,1,1,1,1,1,1,
                1,1,1,1,1,1,1,1,1,
                1,1,1,1,1,1,1,1,1
                
            ]
        },
        {
            "id": 1,
            "name":"Another Map",
            "width": 9,
            "height": 9,
            "grid":
            [
                2,2,2,2,2,2,2,2,2,
                2,2,2,2,2,2,2,2,2,
                2,2,2,2,2,2,2,2,2,
                2,2,2,2,2,2,2,2,2,
                2,2,2,2,2,2,2,2,2,
                2,2,2,2,2,2,2,2,2,
                2,2,2,2,2,2,2,2,2,
                2,2,2,2,2,2,2,2,2,
                2,2,2,2,2,2,2,2,2
                
            ]
        }
    ]
}